########################
#    #           #     #
#    #           #     #
#    #           #     #
#    #           #     #
#    #           #     #
#          #           #
#          #           #
#          #           #
#          #           #
#          #           #
#          #           #
#    #     #     #     #
#    #     #     #     #
#    #     #     #     #
#    #     #     #     #
#    #     #     #     #
######     #############
#                      #
#                      #
#                      #
#                      #
#                      #
########################